REB = "countries/rebels.txt"
PIR = "countries/pirates.txt"
BAR = "countries/barbarians.txt"
MER = "countries/mercenaries.txt"

###WESTERN EUROPE###

# France&GreatBritain
BRI = "countries/bri.txt"
ENG = "countries/eng.txt"
WLH = "countries/wlh.txt"
SCO = "countries/sco.txt"
FRA = "countries/fra.txt"
IR1 = "countries/ir1.txt"
IR2 = "countries/ir2.txt"
IR3 = "countries/ir3.txt"
IR4 = "countries/ir4.txt"
IR5 = "countries/ir5.txt"
IR6 = "countries/ir6.txt"
IR7 = "countries/ir7.txt"
ARL = "countries/arl.txt"

# Holy Roman Empire
POM = "countries/pom.txt"
SIL = "countries/sil.txt"
BOH = "countries/boh.txt"
LUB = "countries/lub.txt"
KRA = "countries/kra.txt"
CAR = "countries/car.txt"
TIR = "countries/tir.txt"
AUS = "countries/aus.txt"
SLZ = "countries/slz.txt"
HLS = "countries/hls.txt"
HAM = "countries/ham.txt"
MKL = "countries/mkl.txt"
BRA = "countries/bra.txt"
MAG = "countries/mag.txt"
ANH = "countries/anh.txt"
SAX = "countries/sax.txt"
SW1 = "countries/sw1.txt"
SW2 = "countries/sw2.txt"
SW3 = "countries/sw3.txt"
BAV = "countries/bav.txt"
BA2 = "countries/ba2.txt"
BA3 = "countries/ba3.txt"
BA4 = "countries/ba4.txt"
NUR = "countries/nur.txt"
BAM = "countries/bam.txt"
WUZ = "countries/wuz.txt"
ANS = "countries/ans.txt"
WUT = "countries/wut.txt"
ULM = "countries/ulm.txt"
RAV = "countries/rav.txt"
HEI = "countries/hei.txt"
FRI = "countries/fri.txt"
FLA = "countries/fla.txt"
HOL = "countries/hol.txt"
PFA = "countries/pfa.txt"
MAI = "countries/mai.txt"
BAD = "countries/bad.txt"
ALS = "countries/als.txt"
BRN = "countries/brn.txt"
BRE = "countries/bre.txt"
COL = "countries/col.txt"
MTZ = "countries/mtz.txt"
UTR = "countries/utr.txt"
GEL = "countries/gel.txt"
OLD = "countries/old.txt"
MUN = "countries/mun.txt"
BRB = "countries/brb.txt"
LUX = "countries/lux.txt"
LIE = "countries/lie.txt"
TRE = "countries/tre.txt"
FRK = "countries/frk.txt"
HES = "countries/hes.txt"
LUN = "countries/lun.txt"
CLE = "countries/cle.txt"
LOR = "countries/lor.txt"
HAI = "countries/hai.txt"
RET = "countries/ret.txt"

# Iberian Peninsula
CAS = "countries/cas.txt"
NAV = "countries/nav.txt"
POR = "countries/por.txt"
ARA = "countries/ara.txt"
LEO = "countries/leo.txt"

# Italy,Corsica&Sardinia
GEN = "countries/gen.txt"
PIS = "countries/pis.txt"
PAP = "countries/pap.txt"
SIC = "countries/sic.txt"
VEN = "countries/ven.txt"
CO1 = "countries/co1.txt"
CO2 = "countries/co2.txt"
CO3 = "countries/co3.txt"
CO4 = "countries/co4.txt"
TRN = "countries/trn.txt"
AQU = "countries/aqu.txt"
VER = "countries/ver.txt"
MAN = "countries/man.txt"
SIE = "countries/sie.txt"
FLO = "countries/flo.txt"
LUC = "countries/luc.txt"
PAR = "countries/par.txt"
BRR = "countries/brr.txt"
MLO = "countries/mlo.txt"
MON = "countries/mon.txt"
CUN = "countries/cun.txt"

# Scandinavia
NOR = "countries/nor.txt"
DAN = "countries/dan.txt"
SWE = "countries/swe.txt"


###EASTERN EUROPE###

# Greece/Balkans
BYZ = "countries/byz.txt"
SER = "countries/ser.txt"
BUL = "countries/bul.txt"
HUN = "countries/hun.txt"
POL = "countries/pol.txt"
PPP = "countries/ppp.txt"
CUM = "countries/cum.txt"
ALN = "countries/aln.txt"
GAV = "countries/gav.txt"
KIE = "countries/kie.txt"
LAT = "countries/lat.txt"
TES = "countries/tes.txt"
ACC = "countries/acc.txt"
ATH = "countries/ath.txt"
EPI = "countries/epi.txt"
TRB = "countries/trb.txt"
NIC = "countries/nic.txt"


###ASIA and AFRICA###

# Anatolia
CIL = "countries/cil.txt"
RUM = "countries/rum.txt"

# Irak, Iran, Armenia
GEO = "countries/geo.txt"
ARM = "countries/arm.txt"
AZZ = "countries/azz.txt"
ABS = "countries/abs.txt"
FAR = "countries/far.txt"
KHO = "countries/kho.txt"

# Crusader States
JER = "countries/jer.txt"
ANT = "countries/ant.txt"
TRI = "countries/tri.txt"
CYP = "countries/cyp.txt"

# North Africa, Egypt, Syria
ALA = "countries/ala.txt"
AYY = "countries/ayy.txt"
ALM = "countries/alm.txt"
LYB = "countries/lyb.txt"
